21 21
0 0
20 19
..###################
....#.....#...#.....#
###.#.###.#.#.#.#####
#...#.#.....#.....#.#
###.###.#####.#####.#
#...#.#.#...#.....#.#
#.#.#.#.#.###.###.#.#
#.#.#.....#.....#...#
#.###########.###.###
#.....#.........#...#
###.###.###.#######.#
#.....#...#.#...#.#.#
#.#.#.#.###.#.###.###
#.#.#...#.....#.#...#
#.###.###.###.#.#.###
#...#.#...#.#...#...#
#.#.###.#.#.#.#.#.#.#
#.#.#...#...#.#.#.#.#
#######.###.#.#.###.#
#.......#...#.#.....#
###################.#