21 21
0 0
19 20
..###################
........#.#.#.....#.#
#####.#.#.#.###.###.#
#...#.#.#...........#
#.#####.#####.###.###
#.....#.........#...#
#.###.#.#####.#######
#...#.....#.......#.#
###.#########.#.#.#.#
#.........#...#.#.#.#
#.###########.#.#.#.#
#.#...#.#.#.#.#.#...#
#.###.#.#.#.###.#####
#.#.....#.#.........#
#.#####.#.###.###.###
#.#.#.....#.#...#...#
#.#.#.#.###.#.#####.#
#.#...#.#...#.#.....#
#.###.#####.#.###.###
#.........#.....#....
#####################